affichier	vouloir
donner	vouloir
récupérer	vouloir
trouver	vouloir
chercher	vouloir
aimer	vouloir
retourner	vouloir
lister	vouloir
quel	vouloir
voudrais	vouloir
aimerais	vouloir
veux	vouloir
affiche	vouloir
donne	vouloir
récupère	vouloir
trouve	vouloir
cherche	vouloir
aime	vouloir
retourne	vouloir
liste	vouloir
listez-moi	vouloir
parle	mot
parlent	mot
contient	mot
contenir	mot
appartient	mot
appartiennent	mot
proposer	mot
propose	mot
provenant	mot
porte	mot
auteur	mot
porter	mot
texte	article
textes	articles
evenement	article
evenements	articles
titres	articles
titre	article
information	article
mois	date
année	date
combien	 nombre
nombre	 nombre
rubriques	rubrique
auteur	auteur
rubriques	rubrique
numéros	numéro
bulletins	bulletin
téléphone	contact
email	contact
legendeImage	image
images	image